5x5 Test map.
5
5
#####
#+++#
#+x+#
#+++#
#####